1 1 1 1 1 1 1 1 1 1 1 1 1 1 1 1 1 1 1 1 1 1 1 1 1 1 1 1 1 1 1 1 1 1 1 1 1 1 1 1 1 1 1 1 1 1 1 1
3 3 3 4 3 4 3 4 3 4 3 4 2 2 2 2 2 2 3 4 3 4 3 4 3 4 3 4 2 2 2 2 2 2 2 2 2 2 2 2 5 6 7 8 7 8 9 1
10 11 12 13 12 13 12 13 12 13 12 13 14 14 14 14 10 11 12 13 12 13 12 13 12 13 12 13 14 14 14 14 14 14 14 14 14 14 14 14 15 16 17 18 17 18 19 1
20 21 20 21 20 21 20 21 20 21 20 21 22 23 22 23 20 21 20 21 20 21 20 21 20 21 20 21 22 23 22 23 22 23 22 23 22 23 22 23 1 24 25 26 25 26 27 1
28 29 30 31 28 29 28 29 28 29 28 29 12 13 12 13 28 29 30 31 28 29 28 29 28 29 28 29 12 13 12 13 12 13 12 13 32 33 32 33 1 17 34 35 36 26 37 1
20 21 38 39 20 21 20 21 20 21 20 21 20 21 20 21 20 21 38 39 20 21 20 21 20 21 20 21 20 21 20 21 20 21 20 21 38 39 38 39 1 40 41 1 25 26 42 1
30 31 43 1 30 31 30 31 30 31 30 31 30 31 30 31 30 31 43 1 30 31 30 31 30 31 30 31 30 31 30 31 30 31 30 31 43 1 43 1 1 36 44 1 36 26 19 1
38 39 45 46 38 39 38 39 38 39 38 39 38 39 38 39 38 39 45 46 38 39 38 39 38 39 38 39 38 39 38 39 38 39 38 39 45 46 1 1 1 40 42 1 25 26 27 1
47 48 49 50 43 1 47 48 47 48 43 1 47 48 43 1 47 48 49 50 43 1 47 48 47 48 43 1 47 48 43 1 43 1 43 1 49 50 1 1 1 51 52 1 51 53 54 1
55 56 57 58 59 59 55 56 55 56 59 59 55 56 59 59 55 56 57 58 59 59 55 56 55 56 59 59 55 56 59 59 59 59 60 61 57 58 62 63 64 65 66 1 67 68 27 1
69 70 71 72 73 73 69 70 69 70 73 73 69 70 73 73 69 70 71 72 73 73 69 70 69 70 73 73 69 70 73 73 73 73 74 75 71 72 76 74 77 78 79 1 79 80 80 1
1 1 1 1 1 1 1 1 1 1 1 1 1 1 1 1 1 1 1 1 1 1 1 1 1 1 1 1 1 1 1 1 1 1 1 1 1 1 1 1 1 1 1 1 1 1 1 1